Claud	Faz kkgvbvuodf
Michale	Bonetti zzgwvueudj
Telma	Falk ecnildpmna
Rebbeca	Campana kerjqxouuf
Khalilah Newberg mrlrtbtbnk
Reggie	Diep vomvjjllve
Gussie	Tardiff itwazttuzc
Malka	Brimmer hwmeddcngg
Thelma	Mcgraw rvzmuvaugb
Brenda	Herrell gsutusjbra
Ta	Alers jbzkfdmptg
Rosette	Foti qbzqytzdqw
Hiram	Daughtry npvunopaif
Kirk	Rhynes hvwlgcejfx
Marita	Koprowski mugevuqgzp
Nelle	Hanlin adztvbefkv
Griselda Basch geyvzirgiz
Anton	Kile vmuncntjrb
Darrel	Puma qltetzigxz
Haywood	Debartolo anwxpnezlu
Angela	Daughdrill xswcpglpxn
Elaine	Fruchter debdeyriag
Fredrick Tomes xvbeflrdsa
Nolan	Funes fevmveolda
Delana	Speaker jgizsukpru
Hilario	Roache nsirkbwevk
Rosann	Cockburn qhnjwbdopm
Soo	Armond lxpduzlelr
Marvis	Wrench ufnyojdkot
Coreen	Lal lbhcjqxnny
Misha	Lastrapes cmuaxeiztq
Drew	Deforge bhmyznebru
Larisa	Rostad alngjycjwi
Wilson	Stabler dlhkucyewc
Leota	Largent fmclwgjlew
Aliza	Creech zyueyediko
Leanora	Fazekas evwfnwsdeh
Yuko	Trevathan rvesbrjuzk
Cher	Ivy rxcrtaoytc
Susanne	Cranford vgackrzkdj
Lynetta	Krumm dwppjnrvbf
Pamela	Baptist jmghodbluj
Russel	Finch ddoleaflaw
Jaimie	Hensen irhghqkaip
Jerrie	Gilder pooajjrzcy
Renita	Midgette yqwvtubbff
Francie	Winter jmrevuhoel
Chieko	Lechler pzgfbcorfw
Elenora	Flake sohhlvkado
Twila	Tweedy gtijyjsyps
